{
	"name": "Test Level",
	"width": 20,
	"tiles": [
		0, 0, 0, 0, 0, 0, 0, 0, 4, 1, 1, 4, 0, 0, 0, 4, 1, 1, 1, 1,
		0, 0, 0, 0, 0, 0, 0, 0, 4, 4, 4, 4, 0, 0, 0, 4, 1, 1, 1, 1,
		4, 4, 4, 4, 0, 0, 4, 4, 4, 0, 4, 4, 0, 0, 0, 4, 1, 1, 1, 1,
		4, 4, 4, 4, 0, 0, 4, 4, 4, 0, 0, 0, 0, 0, 0, 4, 4, 4, 4, 4,
		0, 0, 0, 0, 0, 0, 0, 0, 0, 0, 0, 0, 0, 0, 0, 0, 0, 0, 0, 0,
		4, 4, 4, 4, 0, 0, 4, 4, 4, 0, 0, 1, 0, 0, 0, 4, 4, 4, 4, 4,
		1, 1, 1, 4, 0, 0, 4, 1, 4, 0, 0, 1, 0, 0, 0, 4, 1, 3, 1, 3,
		1, 1, 1, 4, 0, 0, 4, 1, 4, 0, 0, 1, 0, 0, 0, 4, 4, 4, 4, 4,
		1, 1, 1, 4, 0, 0, 2, 2, 2, 0, 0, 1, 0, 0, 0, 0, 0, 0, 0, 0,
		1, 1, 1, 4, 0, 0, 2, 2, 2, 0, 0, 0, 0, 0, 0, 0, 0, 0, 0, 0,
		1, 1, 1, 4, 0, 0, 2, 2, 2, 0, 2, 2, 0, 0, 0, 4, 4, 4, 4, 4,
		4, 4, 4, 4, 0, 0, 2, 2, 2, 0, 2, 2, 0, 0, 0, 4, 1, 1, 1, 1,
		4, 2, 2, 4, 0, 0, 4, 1, 4, 1, 4, 1, 0, 0, 0, 4, 3, 1, 1, 1,
		4, 2, 3, 4, 0, 0, 4, 3, 4, 4, 4, 1, 0, 0, 0, 4, 1, 1, 1, 2,
		4, 4, 4, 4, 0, 0, 4, 4, 4, 4, 4, 4, 0, 0, 0, 4, 1, 1, 1, 2,
		0, 0, 0, 0, 0, 0, 4, 0, 0, 0, 0, 0, 0, 0, 0, 4, 1, 1, 1, 3,
		0, 0, 0, 0, 0, 0, 4, 0, 0, 0, 0, 0, 0, 0, 0, 4, 1, 1, 1, 1,
		4, 4, 4, 4, 4, 4, 4, 0, 0, 4, 4, 4, 4, 4, 4, 4, 1, 1, 1, 1,
		3, 3, 1, 3, 1, 1, 4, 0, 0, 4, 1, 1, 1, 1, 1, 3, 3, 3, 3, 3,
		1, 1, 1, 1, 1, 1, 4, 0, 0, 4, 1, 1, 1, 1, 3, 3, 3, 3, 3, 3
	],
	"spawns": [
		{
			"typeString": "Player",
			"position": {"x": 13, "y": 0}
		},
		{
			"typeString": "Guard",
			"position": {"x": 15, "y": 4},
			"settings": ["heading", "west"],
			"path":["15,4","14,4","13,4","12,4","11,4","10,4","9,4","8,4","7,4","6,4","5,4","6,4","7,4","8,4","9,4","10,4","11,4","12,4","13,4","14,4"]
		},
		{
			"typeString": "Guard",
			"position": {"x": 13, "y": 8},
			"settings": ["heading", "west"],
			"path":["13,8","14,8","15,8","16,8","17,8","18,8","19,8","18,8","17,8","16,8","15,8","14,8"]
		},
		{
			"typeString": "Guard",
			"position": {"x": 10, "y": 7},
			"settings": ["heading", "south"],
			"path":["10,7","10,6","10,5","10,4","10,5","10,6"]
		},
		{
			"typeString": "Guard",
			"position": {"x": 0, "y": 15},
			"settings": ["heading", "east"],
			"path":["0,15","1,15","2,15","3,15","3,14","3,13","3,12","3,11","3,10","3,9","3,8","3,7","3,6","3,7","3,8","3,9","3,10","3,11","3,12","3,13","3,14","3,15","2,15","1,15"]
		},
		{
			"typeString": "Guard",
			"position": {"x": 4, "y": 1},
			"settings": ["heading", "north"],
			"path":["4,1","4,2","4,3","4,4","4,5","4,6","4,7","4,6","4,5","4,4","4,3"]
		}
	]
}